1111111111111
10J10000000C1
1000011111001
1P0011E000H01
1111111111111